111111111111111111111111
110000000000000000100001
1100000P0000000001100001
110000000000000000100001
110000000000000000100001
110001111000000000100001
110000000000000000111111
111100000000000000011111
100000000000000011110001
100000000000001000000011
100000000000000000011111
111100000000000000011111
110000000000000000011111
110000000000000000000011
110000000000000000000001
110000000000000000000001
110000010000000000000001
111111111111111111111111
111111111111111111111111